You find yourself in a strange desert. The strangeness is primarily because you don't recall being in a desert when you went to sleep last night. Yet you feel that this is a familliar place. Like  you've been here before.  The desert extends in every direction. The sun beats down relentlessly drawing moisture from your body. Another day, another desert. That's what my mother used to say.

Wasteland
Nearby is your tent. Your only respite from the heat. 

You can also see Sand here.

AsYouWalk
An Interactive Fiction by Jack Murray
Release 1 / Serial number 200427 / Inform 7 build 6M62 (I6/v6.33 lib 6/12N) SD

Wasteland
Nearby is your tent. Your only respite from the heat. 

You can also see Sand here.

>x backpakc
You can't see any such thing.

>x backpack
In your backpack are canteen, trail rations and a sleepingbag.

* * *

>x flap
You see nothing special about flap.

>enter flap
Wasteland
 The sun beats down relentlessly.

You can see flap here.

>enter flap
Tent
The interior of the tent is dim. The canvas walls protect you from the sun. The tent flaps lead ouside.

A backpack hangs on the center pole.

You can see flap here.

* * *

>go east
Wasteland
You can see Small Tent (empty) and Sand here.

>take sand
You pick up a hand full of sand. It slowly falls through your fingers. You're getting sick of sand. Its course and gets everywhere.

* * *

>west
(row 19)  | This is room 19. |.

>w
(row 15)  | This is room 15. |.

>w
(row 1)  | This is room 1. |.

>w
(row 3)  | This is room 3. |.

>w
(row 20)  | This is room 20. |.

>w
(row 3)  | This is room 3. |.

>w
(row 7)  | This is room 7. |.

>w
(row 16)  | This is room 16. |.

* * *

>w
As you walk the sands shift. The terrain is unrecognizable. You are just as lost as before.
How do we decide what is important? 
But they took everything. 
You can only wander. 
To the west you see what could be the outline of trees. To the east lies a flat expanse of sand. To the north more dunes. Something unspeakable lies to the south.

>e
(row 12)  | This is room 12. |.

>n
(row 10)  | This is room 10. |.

>down
(row 7)  | This is room 7. |.

>up
(row 2)  | This is room 2. |.

>s
(row 3)  | This is room 3. |.

* * *

>w
As you walk the sands shift. The terrain is unrecognizable. You are just as lost as before.
How do we decide what is important? 
But they took everything. 
You can only wander. 
To the west you see what could be the outline of trees. To the east lies a flat expanse of sand. To the north more dunes. Something unspeakable lies to the south.

I beg your pardon?

>look
Wasteland
You can see Sand here.

>find tent
That's not a verb I recognise.

>look for small tent
You can't see any such thing.

* * *

I beg your pardon?

>w
This is room 9..

>w
This is room 20..

I beg your pardon?

>w
This is room 1..

>w
This is room 13..

>w
This is room 6..

>w
This is room 17..

>w
This is room 8..

>w
This is room 1..

>w
This is room 10..

>w
This is room 16..

You're dying of thirst.

>w
This is room 13..

You're dying of thirst.

>w
This is room 3..

You're dying of thirst.

>w
This is room 10..

You're dying of thirst.

>w
This is room 20..

You're dying of thirst.
You Ded

    *** You collapse in onto the sandy ground, unable to muster the energy to keep moving. As the sand shifts to cover your body, you let out a final sigh. Now you can rest. ***

Would you like to RESTART, RESTORE a saved game, QUIT or UNDO the last command?

* * *

>w
As you walk the sands shift. The terrain is unrecognizable. You are just as lost as before.
How do we decide what is important? 
But they took everything. 
You can only wander. 
To the west you see what could be the outline of trees. To the east lies a flat expanse of sand. To the north more dunes. Something unspeakable lies to the south.

>w
As you walk the sands shift. The terrain is unrecognizable. You are just as lost as before.
The sun beats down. The sand glows a warm orange with the reflected light. 
If only you'd been somewhere else. Some kind of gorge or ravine sounds nice.  
Its not so bad once you get used to the humidity. 
The sand blasted wasteland extends in all directions. In the distance to the west you think you see a caravan.

>w
As you walk the sands shift. The terrain is unrecognizable. You are just as lost as before.
Grains of sand 
  cascading 
 as if the world was an hourglass. 
Climbing through the dunes. Like words on a page. An endless reading. 
Its not so bad once you get used to the humidity. 
A river runs through here. The water is rising. Lapping at your shoes. Then suddenly it is gone. .

>w
As you walk the sands shift. The terrain is unrecognizable. You are just as lost as before.
Despite everything behind you, you are still here. 
If only you could slow your mind down. Maybe then you wouldn't be so tired.  
Its a dry heat. 
You find yourself standing on a tall dune. To the south is a steep slope leading down. North leads further up the slope. The dune extends to the east and west.

>w
As you walk the sands shift. The terrain is unrecognizable. You are just as lost as before.
The sun beats down. The sand glows a warm orange with the reflected light. 
Existing in your own mind is a challenge. 
You want to be there, but cannot summon the courage. 
There is only sand in every direction. You wonder if there is any end to this wasteland.

>w
As you walk the sands shift. The terrain is unrecognizable. You are just as lost as before.
The sun beats down. The sand glows a warm orange with the reflected light. 
The endless trek. From here to there. 
Surely there must be more than this. 
The sun falls over the distant horizon bringing in the darkness. With the darkness comes the cold. A relief  
from this endless heat.

>w
As you walk the sands shift. The terrain is unrecognizable. You are just as lost as before.
Do you remember how you got here? 
If only you could slow your mind down. Maybe then you wouldn't be so tired.  
Is there an alternative? 
They say it gets dark at night. This is true in more ways than one. I've lost the way.

>w
As you walk the sands shift. The terrain is unrecognizable. You are just as lost as before.
You are alone with your thoughts. A personal hell. 
Step. Step. Slide. Step. Slide. Slide. 
Remember to take a break every couple of hours.  
To the east you see what could be the light of a campfire.

>w
As you walk the sands shift. The terrain is unrecognizable. You are just as lost as before.
There is peace in solitude.  
You don't think there have been any reports of worms in this desert. 
What are you running from? 
A dark shadow passes over your head, obscuring the light of the moon. Whatever caused it seems to be heading east.

>w
As you walk the sands shift. The terrain is unrecognizable. You are just as lost as before.
Your shoes are always full of sand. No matter how much you try. 
If only you'd been somewhere else. Some kind of gorge or ravine sounds nice.  
It is a struggle. This journey. 
In the distance to the north you see the shifting outlines of shapes moving in the darkness. Could they be people braving the wasteland night?

>w
As you walk the sands shift. The terrain is unrecognizable. You are just as lost as before.
I used to be a king. 
Like looking through a window. Where everything is external. 
Coming here wasn't a mistake. Was it? 
The darkness obscures your vision. No stars are visible and the moon has disappeared.

>w
As you walk the sands shift. The terrain is unrecognizable. You are just as lost as before.
How often have you been here? 
What are you running toward? 
Is there an alternative? 
In the distance to the north you see the shifting outlines of shapes moving in the darkness. Could they be people braving the wasteland night?

>w
As you walk the sands shift. The terrain is unrecognizable. You are just as lost as before.
You are alone with your thoughts. A personal hell. 
You don't think there have been any reports of worms in this desert. 
This path leads somewhere. It must.  
Just ahead you see a light. Flickering softly in the darkness of the night. Calling you forward.

>w
As you walk the sands shift. The terrain is unrecognizable. You are just as lost as before.
Here behind those eyes. There is something you should know.  
Like looking through a window. Where everything is external. 
Coming here wasn't a mistake. Was it? 
From the south a horrifying sound. Of inconsolable rage. Of unending hunger. Unquenchable desire. Fear permiates your bones.

>w
As you walk the sands shift. The terrain is unrecognizable. You are just as lost as before.
How often have you been here? 
You don't think there have been any reports of worms in this desert. 
Is there an alternative? 
From the south a horrifying sound. Of inconsolable rage. Of unending hunger. Unquenchable desire. Fear permiates your bones.

>w
As you walk the sands shift. The terrain is unrecognizable. You are just as lost as before.
Isolation is hard. It never gets any easier. 
You know you can do better. 
Coming here wasn't a mistake. Was it? 
To the east you see what could be the light of a campfire.

>w
As you walk the sands shift. The terrain is unrecognizable. You are just as lost as before.
It's a crisis of creativity.  
If only you'd been somewhere else. Some kind of gorge or ravine sounds nice.  
Gut wrenching business. 
The edges of the plateau drop away to the east and the west. What lies to the north remains hidden. Your heard skips a beat at the thought of going south.
You're dying of thirst.

>w
As you walk the sands shift. The terrain is unrecognizable. You are just as lost as before.
Do you remember when there were plants? A green planet. How strange. 
Tonight you'll howl with the wolves.  
Gut wrenching business. 
To the east you see what could be the light of a campfire. 
You're dying of thirst.

>w
As you walk the sands shift. The terrain is unrecognizable. You are just as lost as before.
Do you remember how you got here? 
The endless trek. From here to there. 
Its not so bad once you get used to the humidity. 
A dark shadow passes over your head, obscuring the light of the moon. Whatever caused it seems to be heading east.
You're dying of thirst.

>w
As you walk the sands shift. The terrain is unrecognizable. You are just as lost as before.
Here behind those eyes. There is something you should know.  
The endless trek. From here to there. 
Remember to take a break every couple of hours.  
Darkness to the south. The east a blank canvas set agains the night sky. The west contains the looming silhouettes of the dunes. The north is a reflection.
You're dying of thirst.

>w
This is room 8..

You're dying of thirst.

>w
This is room 9..

You're dying of thirst.

>w
This is room 3..

You're dying of thirst.

* * *

>w
This is room 10..

You're dying of thirst.

>w
This is room 11..

You're dying of thirst.

>w
This is room 18..

You're dying of thirst.

>w
This is room 4..

You're dying of thirst.

>w
This is room 4..

You're dying of thirst.

>w
This is room 3..

You're dying of thirst.

>w
This is room 8..

You're dying of thirst.

>w
This is room 5..

You're dying of thirst.

>w
This is room 16..

You're dying of thirst.

>w
This is room 14..

You're dying of thirst.

>w
This is room 12..

You're dying of thirst.

I beg your pardon?

>w
This is room 13..

You're dying of thirst.

>w
This is room 15..

You're dying of thirst.

>w
This is room 18..

You're dying of thirst.

>w
This is room 1..

You're dying of thirst.

>w
This is room 17..

You're dying of thirst.

>w
This is room 4..

You're dying of thirst.

>w
This is room 7..

You're dying of thirst.

I beg your pardon?

>w
This is room 12..

You're dying of thirst.

>w
This is room 20..

You're dying of thirst.

>w
This is room 16..

You're dying of thirst.

* * *

>w
As you walk the sands shift. The terrain is unrecognizable. You are just as lost as before.
Here behind those eyes. There is something you should know.  
The endless trek. From here to there. 
Remember to take a break every couple of hours.  
Darkness to the south. The east a blank canvas set agains the night sky. The west contains the looming silhouettes of the dunes. The north is a reflection.
You're dying of thirst.

I beg your pardon?

>w
As you walk the sands shift. The terrain is unrecognizable. You are just as lost as before.
The sun beats down. The sand glows a warm orange with the reflected light. 
Step. Step. Slide. Step. Slide. Slide. 
Change is a constant. Always in flux. It does not exist within a single moment.  
From the south a horrifying sound. Of inconsolable rage. Of unending hunger. Unquenchable desire. Fear permiates your bones.
You're dying of thirst.

    *** You collapse in onto the sandy ground, unable to muster the energy to keep moving. The sands shift. ***

Would you like to RESTART, RESTORE a saved game, QUIT or UNDO the last command?

>w
Please give one of the answers above.

Would you like to RESTART, RESTORE a saved game, QUIT or UNDO the last command?

>w
Please give one of the answers above.

Would you like to RESTART, RESTORE a saved game, QUIT or UNDO the last command?

* * *

>w
As you walk the sands shift. The terrain is unrecognizable. You are just as lost as before.
Despite everything behind you, you are still here. 
If only you could slow your mind down. Maybe then you wouldn't be so tired.  
Its a dry heat. 
You find yourself standing on a tall dune. To the south is a steep slope leading down. North leads further up the slope. The dune extends to the east and west.

I beg your pardon?

>w
This is room 17..

>w
This is room 16..

>w
This is room 17..

>w
This is room 5..

>w
This is room 1..

>w
This is room 8..

>w
This is room 5..

>w
This is room 19..

You're dying of thirst.

>w
This is room 2..

You're dying of thirst.

>w
This is room 20..

You're dying of thirst.

>w
This is room 12..

You're dying of thirst.

>w
This is room 3..

You're dying of thirst.

>w
This is room 19..

You're dying of thirst.

>w
This is room 8..

You're dying of thirst.

* * *

I beg your pardon?

I beg your pardon?

>w
This is room 13..

>w
This is room 1..

>w
This is room 3..

>w
This is room 2..

>w
This is room 1..

>w
This is room 12..

>w
This is room 9..

You're dying of thirst.

>w
This is room 1..

You're dying of thirst.

>w
This is room 13..

You're dying of thirst.

>w
This is room 6..

You're dying of thirst.

>w
This is room 8..

You're dying of thirst.

>w
This is room 7..

You're dying of thirst.

* * *

>take tent
Taken.

>inventory
You are carrying:
  Small Tent

>place small tent
That's not a verb I recognise.

>drop small tent
Dropped.

>look
Wasteland
You can see Small Tent (empty) and Sand here.

>take tent
Taken.

* * *

>inventory
You are carrying:
  Small Tent

>w
No such row
.

>w
(row 13)  | This is room 13. |.

>w
(row 19)  | This is room 19. |.

>w
(row 12)  | This is room 12. |.

>w
(row 6)  | This is room 6. |.

>w
(row 18)  | This is room 18. |.

>w
No such row
.

>w
No such row
.

>w
(row 6)  | This is room 6. |.

>w
(row 2)  | This is room 2. |.

>w
(row 9)  | This is room 9. |.

>w
(row 2)  | This is room 2. |.

* * *

>w
(row 9)  | This is room 9. |.

>w
(row 17)  | This is room 17. |.

>w
(row 19)  | This is room 19. |.

* * *

>w
(row 12)  | This is room 12. |.

>w
(row 10)  | This is room 10. |.

>inventory
You are carrying:
  Small Tent

>drop tent
Dropped.

>inventory
You are carrying nothing.

>w
(row 20)  | This is room 20. |.

>look
Wasteland
You can see Sand here.

>take tent
You can't see any such thing.

>take sand
You pick up a hand full of sand. It slowly falls through your fingers. You're getting sick of sand. Its course and gets everywhere.

* * *

>take tent
Taken.

>set up tent
Dropped.

* * *

>take tent
Taken.

>drop tent
You begin the work of making camp. You've had a lot of practice assembling the tent and complete the task quickly.

>enter tent
You lift the tent flap and go inside. 
Tent Interior
The interior of the tent is dim. The canvas walls protect you from the sun. The tent flaps lead ouside.

A backpack hangs on the center pole.

>exit tent
I only understood you as far as wanting to exit.

>exit
You grab your backpack and exit the tent.

Wasteland
You can see Small Tent (empty) and Sand here.

>take tent
Taken.

>set up tent
You begin the work of making camp. You've had a lot of practice assembling the tent and complete the task quickly.

>take tent
Taken.

>enter
You must supply a noun.

>tent
That's not a verb I recognise.

>enter tent
Your tent is all packed up. Physics says you can't carry yourself on your own back. Sometimes its ok to rely support from others. Like this soft sandy ground.

>set up tent
You begin the work of making camp. You've had a lot of practice assembling the tent and complete the task quickly.

>enter tent
You lift the tent flap and go inside. 
Tent Interior
The interior of the tent is dim. The canvas walls protect you from the sun. The tent flaps lead ouside.

>exit
You grab your backpack and exit the tent.

Wasteland
You can see Small Tent (empty) and Sand here.

>e
This is room 11..

>w
This is room 3..

>enter tent
You can't see any such thing.

* * *

>eat
What do you want to eat?

>sand
No such row
.

* * *

>e
This is room 14..

>e
This is room 13..

>e
This is room 20..

>e
This is room 15..

>e
This is room 13..

>e
This is room 16..

>w
This is room 5..

>w
This is room 12..

>a
That's not a verb I recognise.

>s
This is room 11..

>w
This is room 17..

>e
This is room 20..

>n
This is room 13..

* * *

>enter tent
You lift the tent flap and go inside. 
Tent Interior
The interior of the tent is dim. The canvas walls protect you from the sun. The tent flaps lead ouside.

A backpack hangs on the center pole.

>w
This is room 18..

* * *

>enter tent
You lift the tent flap and go inside. 
Tent Interior
The interior of the tent is dim. The canvas walls protect you from the sun. The tent flaps lead ouside.

A backpack hangs on the center pole.

>exit
You grab your backpack and exit the tent.

Wasteland
Nearby is your tent. Your only respite from the heat. 

You can also see Sand here.

>quit
Are you sure you want to quit?

* * *

>take tent
Taken.

>enter tent
You lift the tent flap and go inside. 
Tent Interior
The interior of the tent is dim. The canvas walls protect you from the sun. The tent flaps lead ouside.

>exit
You grab your backpack and exit the tent.

Wasteland
You can see Sand here.

* * *

>exit
You grab your backpack and exit the tent.

Wasteland
Nearby is your tent. Your only respite from the heat. 

You can also see Sand here.

>take tent
Taken.

>enter tent
Your tent is all packed up. Physics says you can't carry yourself on your own back. Sometimes its ok to rely support from others. Like this soft sandy ground.

>drop tent
Dropped.

>enter tent
You lift the tent flap and go inside. 
Tent Interior
The interior of the tent is dim. The canvas walls protect you from the sun. The tent flaps lead ouside.

* * *

>enter tent
You lift the tent flap and go inside. 
Tent Interior
The interior of the tent is dim. The canvas walls protect you from the sun. The tent flaps lead ouside.

A backpack hangs on the center pole.

>take all
your backpack: Taken.
canteen: Taken.
sleepingbag: Taken.

>exit
You grab your backpack and exit the tent.

Wasteland
Nearby is your tent. Your only respite from the heat. 

You can also see Sand here.

>drink
What do you want to drink?

>canteen
You take a sip from your handy canteen.
 You're feeling quenched.

>drink canteen
You take a sip from your handy canteen.
 You're feeling quenched.

>drink canteen
You take a sip from your handy canteen.
You're feeling thirsty.

* * *

>exit
You grab your backpack and exit the tent.

Wasteland
Nearby is your tent. Your only respite from the heat. 

You can also see Sand here.

>drink canteen
You take a sip from your handy canteen.
 You're feeling quenched.

>w
As you walk the sands shift.
 
*** Run-time problem P22: Attempt to look up a non-existent row in the table 'Table of Musings'.

q w eThis is room 14.

* * *

>enter
You must supply a noun.

>enter tent
You lift the tent flap and go inside. 
Tent Interior
The interior of the tent is dim. The canvas walls protect you from the sun. The tent flaps lead ouside.

A backpack hangs on the center pole.

* * *

>tent
That's not a verb I recognise.

>enter tent
You lift the tent flap and go inside. 
Tent Interior
The interior of the tent is dim. The canvas walls protect you from the sun. The tent flaps lead ouside.

A backpack hangs on the center pole.

* * *

>drink canteen
You take a sip from your handy canteen.
 You're feeling quenched.

>w
As you walk the sands shift.
 q w eThis is room 11.

>w
As you walk the sands shift.
 q w eThis is room 9.

* * *

>Hydration
That's not a verb I recognise.

* * *

>show hydration
You can't see any such thing.

* * *

>drink
What do you want to drink?

>water
You can't see any such thing.

>drinking
That's not a verb I recognise.

>drink
What do you want to drink?

>anything
You can't see any such thing.